NO ./file.xpm   
SO ./file.xpm
EA ./file.xpm
WE ./file.xpm

C 1 30 0,
F 255,100,0   

        1111111111111111111111111
        1000000000110000000000001
        1011000001110000000000001
        1001000000000000000000001
111111110110000011100000000000011
100000000011000001110111111111111
11110111111111011100000010001
11110111111111011101010010001              
11000000110101011100000010001
1000000000000000110000N010001
10000000000000001101010010001
11000001110101011111011110111
11110111 1110101 101111010001
11111111111111111111111111111