NO ./text/wall7.xpm
EA ./text/wall6.xpm
WE ./text/door.xpm
SO ./text/wall3.xpm

F 128,128,128             
C 150,150,200


        1111111111111111111111111111111   
        10000000001 10000000000001
        101100000111000000100000101
        100100000000000001S0000011
111111110011000001110000000000001
100000000011000001110111111111111
11110111111111011100000010001                   
11110111111111011101010010001                       
11000000110101011100000010001                       
1000010000000000000000100011                       
10000010000000001001010010001                       
1100000111010101100101111000111
11110111 1110101 101111010001                       
11111111 11111111111111111111
