NO ./text/ddd.xpm
SO ./text/door.xpm
EA ./text/yellow.xpm
WE ./text/wall4.xpm

F 100,200,10
C 1,30,00

        1111111111111111111111111
        1000000000110000000000001
        1011000001110000000000001
        1001000000000000000000001
111111110011000001110000000000001
100000000011000001110111111111111
11110111111111011100000010001
11110111111111011101010010001
11000000110101011100000010001
1000010000000000000E000010001
10000010000000001001010010001
1100000111010101100101111000111
11110111 1110101 101111010001
11111111111111111111111111111